0  g  0  g  0  0  0  t  0  0  0  b  0  b  0  0  p  p  p  0
0  g  0  g  0  0  t  0  t  0  0  b  0  b  0  0  p  0  0  0
0  g  0  g  0  0  t  0  t  0  0  b  0  b  0  0  p  0  0  0
0  g  g  g  0  0  t  t  t  0  0  b  0  b  0  0  p  p  0  0
0  g  0  g  0  0  t  0  t  0  0  b  0  b  0  0  p  0  0  0
0  g  0  g  0  0  t  0  t  0  0  0  b  0  0  0  p  0  0  0
0  g  0  g  0  0  t  0  t  0  0  0  b  0  0  0  p  p  p  0
0  0  0  0  0  0  0  0  0  0  0  0  0  0  0  0  0  0  0  0
0  0  r  r  r  0  0  o  0  o  0  0  y  0  0  y  0  0  s  0
0  0  r  0  0  0  0  o  0  o  0  0  y  0  0  y  0  0  s  0
0  0  r  0  0  0  0  o  0  o  0  0  y  y  0  y  0  0  s  0
0  0  r  r  0  0  0  o  0  o  0  0  y  y  0  y  0  0  s  0
0  0  r  0  0  0  0  o  0  o  0  0  y  0  y  y  0  0  0  0
0  0  r  0  0  0  0  o  o  o  0  0  y  0  y  y  0  0  0  0
0  0  r  0  0  0  0  0  o  0  0  0  y  0  0  y  0  0  s  0

ball_speed 250.0
paddle_speed  250.0
lives   3
points_per_block  1






